XXXXXXXXXXXXXXXXXXXXXXXXXXXXXXXXXXXXXXXXXXXXXXXXXXXXXXXXXXXXXXXXXXXXXXXXXXXXXXXXXXXXXXX
X                                                                                     X
X                                                                                     X
X                                                                                     X
X                                                                                     X
X                                                                                     X
X                                                                                     X
X                                                                                     X
X                                                                                     X
X                                                                                     X
X                                                                                     X
X                                                                                     X
X                                                                                     X
X                                                                                     X
X                                                                                     X
X                                                                                     X
X                                                                                     X
X                                                                                     X
X                                                                                     X
X                                                                               XXXXXXX
X                                                                               X     X
X                                                                                     X     
X—||-——————--                                                                   X  ?  X
X LABORATORY|                                                                   X     X
XXXXXXXXXXXXXXXXXXXXXXXXXXXXXXXXXXXXXXXXXXXXXXXXXXXXXXXXXXXXXXXXXXXXXXXXXXXXXXXXXXXXXXX