XXXXXXXXXXXXXXXXXXXXXXXXXXXXXXXXXXXXXXXXXXXXXXXXXXXXXXXXXXXXXXXXXXXXXXXXXXXXXXXXXXXXXXX
X                                                                                     X
X                                                                                     X
X                                                                                     X
X                                                                                     X
X                                                                                     X
X                                                                                     X
X                                                                                     X
X                                                                                     X
X                                                                                     X
X                                                                                     X
X                                                                                     X
X                                                                                     X
X                                                                                     X
X                                                                                     X
X                                                                                     X
X                                                                                     X
X                                                                                     X
X                                                                                     X
X                                                                               XXXXXXX
X                                                                               X     X
X—-LAB—                                                                         ?     X     
X      |                                                                        X  G  X
X      |                                                                        X     X
XXXXXXXXXXXXXXXXXXXXXXXXXXXXXXXXXXXXXXXXXXXXXXXXXXXXXXXXXXXXXXXXXXXXXXXXXXXXXXXXXXXXXXX