XXXXXXXXXXXXXXXXXXXXXXXXXXXXXXXXXXXXXXXXXXXXXXXXXXXXXXXXXXXXXXXXXXXXXXXXXXXXXXXXXXXXXXX
X      X     X          X           X                                 X               X
X CLUB X   $            X   GYM     X                                 X  SAN ESCOBAR  X
X      X     X          XXXXXXXXXXXXX                                 X               X
XXXXXXXXXXXXXX          X           X                                 XXXXXXXXXXXXXXXXX
X                       X  $        X                                                 X
X                       XXXXXX  XXXXX                                                 X
X                                                                                     X
X                                                                                     X
X                                                                                     X
X                                                                        XXXXXXXXXXXXXX
X                                                                        X            I
XXXXX                                                                    (   LEVEL 2  I
X   X                                                                    X            I
X B )                                                                    XXXXXXXXXXXXXX
X   X                                                                                 X
XXXXX                                                                                 X
X                                                                                     X
X                                                                                     X
X                          XXXX  XXX                                            XXXXXXX
X                          X       X                                            X     X
X                          X       X                                                  X
X______||____              X  ?    X                                            X  $  X
X LABORATORYX              X       X                                            X     X
XXXXXXXXXXXXXXXXXXXXXXXXXXXXXXXXXXXXXXXXXXXXXXXXXXXXXXXXXXXXXXXXXXXXXXXXXXXXXXXXXXXXXXX
