XXXXXXXXXXXXXXXXXXXXXXXXXXXXXXXXXXXXXXXXXXXXXXXXXXXXXXXXXXXXXXXXXXXXXXXXXXXXXXXXXXXXXXX
X            X                                                                        X
X  GUN SHOP  X                                E                                       X
X            X                                                                        X
XXXXXX=XXXXXXX                            E                                           X
X                                                                                     X
X                                                 E                                   X
X                                         E                                           X
X                                                                                     X
X                                                                              ///////XXXXXXXXXXXXXXXX
]                                                                              /              l      X
]                                                                              l              l BOSS X
]                                                                              \              l      X
]                                                                              \\\\\\\XXXXXXXXXXXXXXXX
]                                                                                     X
X                                                                                     X
X                                                                                     X
X                                                                                     X
X                                                                                     X
X                                                                                     X
X                                                                                     X
X                                                                                     X
X                                                                                     X
X                                                                                     X
XXXXXXXXXXXXXXXXXXXXXXXXXXXXXXXXXXXXXXXXXXXXXXXXXXXXXXXXXXXXXXXXXXXXXXXXXXXXXXXXXXXXXXX
