XXXXXXXXXXXXXXXXXXXXXXXXXXXXXXXXXXXXXXXXXXXXXXXXXXXXXXXXXXXXXXXXXXXXXXXXXXXXXXXXXXXXXXX
X            X                                                                        X
X  GUN SHOP  X                                E                                       X
X            X                                                                        X
XXXXXX-XXXXXXX                            E                                           X
X                                                                                     X
X                                                 E                                   X
X                                         E                                           X
X                                                                                     X
X                                                                              ///////X
                                                                               /      X
                                                                               ( BOSS X
                                                                               \      X
                                                                               \\\\\\\X
                                                                                      X
X                                                                                     X
X                                                                                     X
X                                                                                     X
X                                                                                     X
X                                                                                     X
X                                                                                     X
X                                                                                     X
X                                                                                     X
X                                                                                     X
XXXXXXXXXXXXXXXXXXXXXXXXXXXXXXXXXXXXXXXXXXXXXXXXXXXXXXXXXXXXXXXXXXXXXXXXXXXXXXXXXXXXXXX
