XXXXXXXXXXXXXXXXXXXXXXXXXXXXXXXXXXXXXXXXXXXXXXXXXXXXXXXXXXXXXXXXXXXXXXXXXXXXXXXXXXXXXXX
X            X                                                                        X
X  GUN SHOP  X                                E                                       X
X            X                                                                        X
XXXXXX=XXXXXXX                            E                                           X
X                                                                                     X
X                                                 E                                   X
X                                         E                                           XXXXXXXXXX
X                                                                                     XXXXXXXXXXXXX
X                                                                              XXXXXXXXXXXXXXXXXXXXXXX
]                                                                              X              l      X
]                                                                              <              l BOSS X
]                                                                              X              l      X
]                                                                              XXXXXXXXXXXXXXXXXXXXXXX
]                                                                                     XXXXXXXXXXXXX
X                                                                                     XXXXXXXXXX
X                                                                                     X
X                                                                                     X
X                                                                                     X
X                                                                                     X
X                                                                                     X
X                                                                                     X
X                                                                                     X
X                                                                                     X
XXXXXXXXXXXXXXXXXXXXXXXXXXXXXXXXXXXXXXXXXXXXXXXXXXXXXXXXXXXXXXXXXXXXXXXXXXXXXXXXXXXXXXX
